#########################
#_______________________#
#__p____________________#
#_______________________#
#_______________________#
#_____________c_________#
#_______________________#
#_______________________#
#_______________________#
#_______________________#
#_______________________#
#_______________________#
#_______________________#
#_______________________#
#_______________________#
#_______________________#
#_______________________#
#_______________________#
#_______________________#
#_______________________#
#_______________________#
#_______________________#
#_______________________#
#_______________________#
#########################