################################################################
###################################______#######################
###################################______#######################
###################################______#######################
##########################________#______#######################
##########################________#______#######################
##########################________#______#######################
##_______________________________________#######################
##_______#################________#_############################
##______________________________________________################
##_______##################_####_##_############################
##_______##########_____###_####_##_############################
##_______##########_____###_####_##_############################
##_______##########_____###_####_##_############################
##_______##########_____###_####_##_############################
##_______##########_____###_####_##_############################
##_______##########_____###_####_##_############################
###_###_###########_____###_####_##_________####################
###_###_#_______________###_####_##_________####################
###_###_#_###########_#####_####_##_________####################
###_###_#_###########_#####_####_##_____________________########
###_#________########_#####_####_##_________########_##_########
###_#________########_#####_####_##_________########_##_########
###_#________########_#####_####_##_________##__________########
###_#________########_#####_####_##_________##__________########
###_#________########_#####_####_##_####_##_##__________########
###_#________########_#####_####________________________########
###_#________########_#####_#######_####_##_##__________########
###_#________########_#####_#######_####_##_##__________########
###_#________########_#####_#######_####_##_##__________########
###_#________########_#####_#######_####_##_##__________########
###_#_#_####_########_#####_#######_####_##_#####_##_##_########
###_#_#___________________________________________________######
###_#_######_########_#####_#######_####_##_#####_________######
###_#_######_########_______#######_####_##_#####_________######
###_#_######_########_______#######_####_##_#####_________######
###_#_######_########_______#######_####_##_#####_________######
###_#__________######_______#######_####_##_#####_________######
###_#__________######_______#######_####_##_#####_##_###########
###_#__________######_#_###########_####_##__________###########
###_#________________________________________________###########
###_#________________________________________________###########
###_#__________######_#_###########_####_##__________###########
###_#_###############_#_###########_####_##__________###########
###_#_###############_#_###########_####_##__________###########
###_#_#########_________###########_####_##__________###########
###_#_#########_________###########_####_#######################
##______________________###########_####_#######################
##_____########_________###########_####_#######################
##_____########_________###########_####_#######################
##_____###########_##_#_###########_####_#######################
##_____##________________________________#######################
##################_##_#_###########_############################
##################_##_#_###########__________________###########
##################_##_#_######################_______###########
##################_##_#_####__________########_______###########
##################____________________########_______###########
#####################_#_______________########_______###########
#####################_######__________########_______###########
#####################________________________________###########
################################################################
