#############################################
#############################################
#############################################
#############################################
#############################################
#############################################
#############################################
#############################################
#############################################
##################_________##################
###############_______________###############
#############___________________#############
############_____________________############
###########_______________________###########
###########_______________________###########
###########_______________________###########
###########_______________________###########
###########_______________________###########
###########_______________________###########
###########_______________________###########
############_____________________############
#############___________________#############
###############_______________###############
##################_________##################
######################d######################
#############################################
#############################################
#############################################
#############################################
#############################################
#############################################
#############################################
#############################################